0 0 0 0 0 0 0 0 0 0 0 0 0 0 0 0 0 0 0 0 0 0 0 0 0 0 0 0 0 0 0 0 0 0 0 0 0 0 0 0 0 0 0 0 0 0 0 0
1 1 2 3 2 3 2 3 2 3 2 3 1 1 1 1 1 1 2 3 2 3 2 3 2 3 2 3 1 1 1 1 1 1 1 1 1 1 1 1 4 5 6 7 6 7 8 0
9 10 11 12 11 12 11 12 11 12 11 12 13 13 13 13 9 10 11 12 11 12 11 12 11 12 11 12 13 13 13 13 13 13 13 13 13 13 13 13 14 15 16 17 16 17 18 0
19 20 19 20 19 20 19 20 19 20 19 20 21 22 21 22 19 20 19 20 19 20 19 20 19 20 19 20 21 22 21 22 21 22 21 22 21 22 21 22 0 23 24 25 24 25 26 0
27 28 29 30 27 28 27 28 27 28 27 28 11 12 11 12 27 28 29 30 27 28 27 28 27 28 27 28 11 12 11 12 11 12 11 12 31 32 31 32 0 16 33 34 35 25 36 0
19 20 37 38 19 20 19 20 19 20 19 20 19 20 19 20 19 20 37 38 19 20 19 20 19 20 19 20 19 20 19 20 19 20 19 20 37 38 37 38 0 39 40 0 24 25 41 0
29 30 42 0 29 30 29 30 29 30 29 30 29 30 29 30 29 30 42 0 29 30 29 30 29 30 29 30 29 30 29 30 29 30 29 30 42 0 42 0 0 35 43 0 35 25 18 0
37 38 44 45 37 38 37 38 37 38 37 38 37 38 37 38 37 38 44 45 37 38 37 38 37 38 37 38 37 38 37 38 37 38 37 38 44 45 0 0 0 39 41 0 24 25 26 0
46 47 48 49 42 0 46 47 46 47 42 0 46 47 42 0 46 47 48 49 42 0 46 47 46 47 42 0 46 47 42 0 42 0 42 0 48 49 0 0 0 50 51 0 50 52 53 0
54 55 56 57 58 58 54 55 54 55 58 58 54 55 58 58 54 55 56 57 58 58 54 55 54 55 58 58 54 55 58 58 58 58 59 60 56 57 61 62 63 64 65 0 66 67 26 0
68 69 70 71 72 72 68 69 68 69 72 72 68 69 72 72 68 69 70 71 72 72 68 69 68 69 72 72 68 69 72 72 72 72 73 74 70 71 75 73 76 77 78 0 78 79 79 0
0 0 0 0 0 0 0 0 0 0 0 0 0 0 0 0 0 0 0 0 0 0 0 0 0 0 0 0 0 0 0 0 0 0 0 0 0 0 0 0 0 0 0 0 0 0 0 0