0 0 0 0 0 0 0 0 0 0 0 0 0 0 0 0 0 0 0 0 0 0 0 0 0 0 0 0 0 0 0 0 0 0 0 0 0 0 0 0 0 0 0 0 0 0 0 0 
1 1 2 3 2 3 2 3 2 3 2 3 1 1 1 1 1 1 2 3 2 3 2 3 2 3 2 3 1 1 1 1 1 1 1 1 1 1 1 1 4 5 6 7 6 7 8 0 
9 10 11 12 11 12 11 12 11 12 11 12 13 13 13 13 9 10 11 12 11 12 11 12 11 12 11 12 13 13 13 13 13 13 13 13 13 13 13 13 14 15 16 17 16 17 18 0 
19 20 19 20 19 20 19 20 19 20 19 20 21 22 21 22 19 20 19 20 19 20 19 20 19 20 19 20 21 22 21 22 21 22 21 22 21 22 21 22 0 23 24 25 24 25 26 0 
27 28 29 30 27 28 27 28 27 28 27 28 11 12 11 12 27 28 29 30 27 28 27 28 27 28 27 28 11 12 11 12 11 12 11 12 31 32 31 32 0 16 33 34 35 25 36 0 
19 20 37 38 19 20 19 20 19 20 19 20 19 20 19 20 19 20 37 38 19 20 19 20 19 20 19 20 19 20 19 20 19 20 19 20 37 38 37 38 0 39 40 0 24 25 41 0 
29 30 0 0 29 30 29 30 29 30 29 30 29 30 29 30 29 30 0 0 29 30 29 30 29 30 29 30 29 30 29 30 29 30 29 30 0 0 0 0 0 35 42 0 35 25 18 0 
37 38 43 44 37 38 37 38 37 38 37 38 37 38 37 38 37 38 43 44 37 38 37 38 37 38 37 38 37 38 37 38 37 38 37 38 43 44 0 0 0 39 41 0 24 25 26 0 
45 46 47 48 0 0 45 46 45 46 0 0 45 46 0 0 45 46 47 48 0 0 45 46 45 46 0 0 45 46 0 0 0 0 0 0 47 48 0 0 0 49 50 0 49 51 52 0 
53 54 55 56 57 57 53 54 53 54 57 57 53 54 57 57 53 54 55 56 57 57 53 54 53 54 57 57 53 54 57 57 57 57 58 59 55 56 60 61 62 63 64 0 65 66 26 0 
67 68 69 70 71 71 67 68 67 68 71 71 67 68 71 71 67 68 69 70 71 71 67 68 67 68 71 71 67 68 71 71 71 71 72 73 69 70 74 72 75 76 77 0 77 78 78 0 
0 0 0 0 0 0 0 0 0 0 0 0 0 0 0 0 0 0 0 0 0 0 0 0 0 0 0 0 0 0 0 0 0 0 0 0 0 0 0 0 0 0 0 0 0 0 0 0 
