0 0
0 1 0 1 2 3 4 5 6 7 8 48
1 0
1 1 8 9 10 11 12 13 14 15 16 49
2 0
2 1 16 17 18 19 20 21 22 23 24 50
3 0
3 1 24 25 26 27 28 29 30 31 32 51
4 0
4 1 32 33 34 35 36 37 38 39 40 52
5 0
5 1 40 41 42 43 44 45 46 47
END
