0 0 1 2 1 2 1 2 1 2 1 2 0 0 0 0 0 0 1 2 1 2 1 2 1 2 1 2 0 0 0 0 0 0 0 0 0 0 0 0 3 4 5 6 5 6 7
8 9 8 9 8 9 8 9 8 9 8 9 0 0 0 0 8 9 8 9 8 9 8 9 8 9 8 9 0 0 0 0 0 0 0 0 0 0 0 0 10 10 11 12 11 12 13
14 15 14 15 14 15 14 15 14 15 14 15 0 0 0 0 14 15 14 15 14 15 14 15 14 15 14 15 1 2 1 2 1 2 1 2 1 2 1 2 10 10 16 12 16 12 17
8 9 18 19 8 9 8 9 8 9 8 9 8 9 8 9 8 9 18 19 8 9 8 9 8 9 8 9 8 9 8 9 8 9 8 9 18 19 18 19 10 20 21 22 11 12 23
14 15 24 25 14 15 14 15 14 15 14 15 14 15 14 15 14 15 24 25 14 15 14 15 14 15 14 15 14 15 14 15 14 15 14 15 24 25 24 25 10 26 27 10 16 12 7
18 19 10 10 18 19 18 19 18 19 18 19 18 19 18 19 18 19 10 10 18 19 18 19 18 19 18 19 18 19 18 19 18 19 18 19 10 10 10 10 10 11 23 10 11 12 13
24 25 28 29 24 25 24 25 24 25 24 25 24 25 24 25 24 25 28 29 24 25 24 25 24 25 24 25 24 25 24 25 24 25 24 25 28 29 10 10 10 26 27 10 16 12 17
30 31 32 33 10 10 30 31 30 31 10 10 30 31 10 10 30 31 32 33 10 10 30 31 30 31 10 10 30 31 10 10 10 10 10 10 32 33 10 10 10 26 34 10 26 35 13
36 37 38 39 40 41 36 37 36 37 40 41 36 37 40 41 36 37 38 39 40 41 36 37 36 37 40 41 36 37 40 41 40 41 42 43 38 39 44 45 46 47 48 10 48 49 17