0 292 293 294 295 296 297 298 299 304 305 306
1 307 308 309 310 311 312 313 314 315 385 386 427 428 429 430 431
2 365 366 367 371 372 373 374 375 376 377 378 380 381 382 383 384
3 219 220 355 356 357 358 359 360 361 362 363 364 368 369 370
4 214 215 216 217 218 221 222 234 235 432 433 434 435 436 437 438 439
5 204 205 206 207 208 212 213 458 459
6 200 201 202 203 209 210 211
7 259 260 261 262 263 264 265 266 300 301 302 303 316 317 400 401 402
8 318 319 320 321 322 323 324 325 326 327 328 329 331 332 333 334 335 403 416 417 418 419
9 290 291 330 336 337 338 339 340 341 342 343 344 345 346 347 379
10 223 224 225 226 252 253 254 255 256 348 349 350 351 352 353 354 404 411 412 413 415 420 421
11 126 127 128 129 130 131 132 133 134 174 175 176 177 178 227 228 229 230 231 231 232 233 236 237 239 240 241 406 414
12 179 180 181 182 183 184 185 186 187 188 195 196 197 198 199 238 408 455 456 457
13 155 156 157 158 159 160 161 162 163 164 189 190 191 192 193 194 407 409
14 70 71 72 73 74 75 76 77 78 79 80 81 82 397 398 399 423 424 425
15 83 84 85 86 87 88 89 90 91 92 267 268 269 270 271 272 273 274 275 276 277 278 279 422 426
16 93 94 95 96 97 98 99 100 101 102 103 104 280 281 282 283 284 285 286 287 288 289 390 391 392 393 394 395 396
17 105 106 107 108 109 110 111 244 245 247 248 249 250 257 258 387 388 389 410
18 112 113 114 115 116 117 119 120 121 122 123 124 125 135 136 137 138 139 165 166 167 168 169 242 243 246 251 445 446
19 140 141 142 143 144 145 146 147 148 149 150 151 170 171 172 173 405 440 441 442 443 444 447 448 449 450 451 452 454 453
20 152 153 154
21 1 2 3 4 5 6 7 8 9 10 11
22 12 13 14 15 16 17 18 19 20 21
23 22 23 24 25 26 27 28 29 30 31
24 32 33 34 35 36 37 38 39 40 41 42
25 43 44 45 46 47 48 49 50 51 52
26 53 54 55 56 57 58 59 60 61 62
27 63 64 65 66 67 68 69
