0 0 156
0 1 155 246 281
0 2 82 152 154 155 247 270
0 3 81 152 191 248
0 4 191 249 250
0 5 79 80
0 6 1 2 3 4 5 6
1 0
1 1 226 246
1 2 82 152 153 228 270
1 3 81 83 107 152 248
1 4 103 151 224 250
1 5 78 79 80 224 225
1 6 6 7 8 9 10 11
2 0
2 1 157 226 227 267
2 2 157 228 278
2 3 83 84 105
2 4 105 106 222 224 252 253
2 5 78 140 224 225 251
2 6 11 12 13 14 15 16
3 0 109 112
3 1 108 110 111 267 277
3 2 98 229 278
3 3 83 84 98 100 271
3 4 104 199 222 252 253
3 5 199 251
3 6 16 17 18 19 20 21
4 0
4 1 110 158 160 221 254 268 282
4 2 97 221 229 272
4 3 97 99 271
4 4 104 187 207 208 209 253 265
4 5 71 73 141 187 251
4 6 21 22 23 24 25 26 72 74
5 0 161 162
5 1 159 192 230 254 268 282 283
5 2 231 242
5 3 195 242 264 271
5 4 197 265 266 276
5 5 75 251
5 6 26 27 28 29 30 31
6 0 188
6 1 188 192 193 194 230 261 262
6 2 220 231 260
6 3 85 101 102 145 263
6 4 144 146 147 148 198 206 275 276
6 5 76 77 198 273
6 6 31 32 33 34 35 36 37
7 0 188
7 1 163 188 189 194 240 261 262
7 2 96 150 189 259 260
7 3 85 92 93 94 96 196 263
7 4 91 144 196 198 232 233
7 5 70 91 198 273 287 288
7 6 36 37 38 39 40 41 42 70
8 0 165
8 1 113 114 163 164 166 167 168 169 240 280 284
8 2 113 149
8 3 93 94 95 234
8 4 232 233 279
8 5 142 143 285 288
8 6 42 43 44 45 46 47 142
9 0 118 119 120 170
9 1 114 115 116 117 118 210 211 212 280 284
9 2 115 202 210
9 3 87 236 237
9 4 87 235 238
9 5 126 127 176 177 178 205 239 290
9 6 47 48 49 50 51 52 176 178 213 290
10 0 171 172 274
10 1 139
10 2 201 202 258
10 3 87 173 200 201 237 257
10 4 87 123 124 125 200 218 238 256
10 5 86 121 122 123 126 175 239 255 291
10 6 52 53 54 55 56 57 175 291
11 0
11 1 138 190 219 241
11 2 136 137 201 219 243 258
11 3 89 135 136 201 257
11 4 132 133 174 218 223 256
11 5 86 128 255
11 6 57 58 59 60 61 62 128
12 0
12 1 217 241 286
12 2 90 183 184 185 186 203 243
12 3 88 89 180 203 244 269
12 4 88 131 132 134 204 244 245
12 5 129 130 131 179 214 215 216 289
12 6 62 63 64 65 66 67 179 214 216
13 0
13 1
13 2 243
13 3 88 181 182 244 269
13 4 88 204 244 245
13 5 216
13 6 67 68 69 216
