0 0
0 1 292 293 294 295 296 300 301
0 2 259 260 261 300 301 401
0 3 70 71 72 73 262 263 400
0 4 70 71 72 73 74 75
0 5 398 399
0 6 1 2 3 4 5 6
1 0
1 1 296 297 298 299 301 302 303 304 305 306
1 2 301 302 303 316 317 401
1 3 263 264 265 266 400 402 426
1 4 75 76 77 78 79 80 81 422
1 5 78 79 80 81 82 397 398 399
1 6 6 7 8 9 10 11
2 0
2 1 306 307 308 309 310 311 312 313 314
2 2 316 317 318 319 320 321 322
2 3 273 274 402 403 424
2 4 81 267 268 269 273 274 424 425
2 5 81 82 83 84 85 86 87 397
2 6 11 12 13 14 15 16
3 0 428 431
3 1 314 315 385 386 427 429 430
3 2 322 323 324 325 326 327 328 329 417
3 3 274 275 276 277 278 279 331 332 333 334 335 402 403 417 419
3 4 269 270 271 272 274 275 276 277 278 279 423
3 5 87 88 89 90 91 92
3 6 16 17 18 19 20 21
4 0
4 1 374 375 376 380 381 382 429
4 2 329 330 374 375 376 379 416
4 3 279 280 281 282 335 336 337 338 339 340 416 418
4 4 279 280 281 282 283 284 285 423
4 5 92 93 94 95 96 97 390 392
4 6 21 22 23 24 25 26 391 393
5 0
5 1 365 366 367 371 372 373 376 377 378 382 383 384
5 2 342 343 344 345 346 347 376 377 378
5 3 287 288 289 290 291 340 341 342 343 344
5 4 101 102 103 104 285 286 287 288 289
5 5 97 98 99 100 394
5 6 26 27 28 29 30 31
6 0
6 1 355 356 357 360 361 362 367 368 369 370
6 2 347 348 349 350 351 352 353
6 3 252 253 254 404 420 421
6 4 104 105 106 107 252 253 254 257 258
6 5 108 109 110 395 396
6 6 31 32 33 34 35 36 37
7 0
7 1 218 219 357 358 359 362 363 364
7 2 222 223 224 225 353 354 415
7 3 254 255 256 404 411 412 413 415
7 4 244 245 247 248 249 250 254 255 256 410
7 5 110 111 387 388 389 410
7 6 36 37 38 39 40 41 42 387
8 0
8 1 213 214 215 216 217 219 220 221 234 235 432 433
8 2 225 226 227 228 229 230 432
8 3 239 240 241 412 413 414
8 4 242 243 245 246 250 251
8 5 112 113 114 242 243 388
8 6 42 43 44 45 46 47
9 0 437 438 439
9 1 217 234 235 433 434 435 436 437
9 2 130 131 132 133 175 176 177 230 231 232 233 236 237 434
9 3 125 126 127 128 129 130 173 174 175 176 177 406
9 4 120 121 122 123 124 125 164 165 166 167 168 406
9 5 115 116 117 118 119 120 134 135 136 137 138 445 446
9 6 47 48 49 50 51 52 115 116
10 0 211 212
10 1 459
10 2 177 178 179 180 194 195 196 237 238
10 3 177 178 179 180 181 182 183 406
10 4 149 168 169 170 171 172 406 442 443 444
10 5 138 139 140 141 142 143 144 145 405 440 441 442 445
10 6 52 53 54 55 56 57
11 0
11 1 203 204 205 206 207 458
11 2 187 196 197 198 456 457
11 3 183 184 185 186 408 455 456
11 4 149 150 452 453
11 5 145 146 147 148 405 447
11 6 57 58 59 60 61 62 447
12 0
12 1 199 200 201 202 207 208 209 210
12 2 187 188 189 190 191 192 409
12 3 155 156 157 160 161 162 163 407 408
12 4 153 155 156 157 407 451 452 454
12 5 448 449 450 451
12 6 62 63 64 65 66 67
13 0
13 1 202
13 2 192 193
13 3 154 155 156 158 159 160 407
13 4 151 152 153 154 155 156 407
13 5
13 6 67 68 69
