0 0 159
0 1 158 249 284
0 2 84 155 157 158 250 273
0 3 83 155 194 251
0 4 194 252 253
0 5 81 82
0 6 1 2 3 4 5 6
1 0
1 1 229 249
1 2 84 155 156 231 273
1 3 83 85 109 155 251
1 4 105 154 227 253
1 5 80 81 82 227 228
1 6 6 7 8 9 10 11
2 0
2 1 160 229 230 270
2 2 160 231 281
2 3 85 86 107
2 4 107 108 225 227 255 256
2 5 80 143 227 228 254
2 6 11 12 13 14 15 16
3 0 111 114
3 1 110 112 113 270 280
3 2 100 232 281
3 3 85 86 100 102 274
3 4 106 202 225 255 256
3 5 202 254
3 6 16 17 18 19 20 21
4 0
4 1 112 161 163 224 257 271 285
4 2 99 224 232 275
4 3 99 101 274
4 4 106 190 210 211 212 256 268
4 5 73 75 144 190 254
4 6 21 22 23 24 25 26 74 76
5 0 164 165
5 1 162 195 233 257 271 285 286
5 2 234 245
5 3 198 245 267 274
5 4 200 268 269 279
5 5 77 254
5 6 26 27 28 29 30 31
6 0 191
6 1 191 195 196 197 233 264 265
6 2 223 234 263
6 3 87 103 104 148 266
6 4 147 149 150 151 201 209 278 279
6 5 78 79 201 276
6 6 31 32 33 34 35 36 37
7 0 191
7 1 166 191 192 197 243 264 265
7 2 98 153 192 262 263
7 3 87 94 95 96 98 199 266
7 4 93 147 199 201 235 236
7 5 70 71 72 93 201 276
7 6 36 37 38 39 40 41 42 70
8 0 168
8 1 115 116 166 167 169 170 171 172 243 283 287
8 2 115 152
8 3 95 96 97 237
8 4 235 236 282
8 5 71 145 146 288
8 6 42 43 44 45 46 47 145
9 0 120 121 122 173
9 1 116 117 118 119 120 213 214 215 283 287
9 2 117 205 213
9 3 89 239 240
9 4 89 238 241
9 5 128 129 179 180 181 208 242
9 6 47 48 49 50 51 52 179 181 216
10 0 174 175 277
10 1 142
10 2 204 205 261
10 3 89 176 203 204 240 260
10 4 89 125 126 127 203 221 241 259
10 5 88 123 124 125 128 178 242 258
10 6 52 53 54 55 56 57 178
11 0
11 1 141 193 222 244
11 2 139 140 204 222 246 261
11 3 91 138 139 204 260
11 4 135 136 177 221 226 259
11 5 88 130 258
11 6 57 58 59 60 61 62 130
12 0
12 1 220 244 289
12 2 92 186 187 188 189 206 246
12 3 90 91 183 206 247 272
12 4 90 134 135 137 207 247 248
12 5 131 132 133 134 182 217 218 219
12 6 62 63 64 65 66 67 182 217 219
13 0
13 1
13 2 246
13 3 90 184 185 247 272
13 4 90 207 247 248
13 5 219
13 6 67 68 69 219
