0 0 155
0 1 154 245 280
0 2 82 151 153 154 246 269
0 3 81 151 190 247
0 4 190 248 249
0 5 79 80
0 6 1 2 3 4 5 6
1 0
1 1 225 245
1 2 82 151 152 227 269
1 3 81 83 106 151 247
1 4 102 150 223 249
1 5 78 79 80 223 224
1 6 6 7 8 9 10 11
2 0
2 1 156 225 226 266
2 2 156 227 277
2 3 83 84 104
2 4 104 105 221 223 251 252
2 5 78 139 223 224 250
2 6 11 12 13 14 15 16
3 0 108 111
3 1 107 109 110 266 276
3 2 97 228 277
3 3 83 84 97 99 270
3 4 103 198 221 251 252
3 5 198 250
3 6 16 17 18 19 20 21
4 0
4 1 109 157 159 220 253 267 281
4 2 96 220 228 271
4 3 96 98 270
4 4 103 186 206 207 208 252 264
4 5 71 73 140 186 250
4 6 21 22 23 24 25 26 72 74
5 0 160 161
5 1 158 191 229 253 267 281 282
5 2 230 241
5 3 194 241 263 270
5 4 196 264 265 275
5 5 75 250
5 6 26 27 28 29 30 31
6 0 187
6 1 187 191 192 193 229 260 261
6 2 219 230 259
6 3 85 100 101 144 262
6 4 143 145 146 147 197 205 274 275
6 5 76 77 197 272
6 6 31 32 33 34 35 36 37
7 0 187
7 1 162 187 188 193 239 260 261
7 2 188 258 259 291 291
7 3 85 92 93 195 262 291 291
7 4 143 195 197 231 232 291
7 5 70 197 272 286 287
7 6 36 37 38 39 40 41 42 70
8 0 164
8 1 112 113 162 163 165 166 167 168 239 279 283
8 2 112 148
8 3 92 93 94 233 291
8 4 231 232 278
8 5 141 142 284 287
8 6 42 43 44 45 46 47 141
9 0 117 118 119 169
9 1 113 114 115 116 117 209 210 211 279 283
9 2 114 201 209
9 3 87 235 236
9 4 87 234 237
9 5 125 126 175 176 177 204 238 289
9 6 47 48 49 50 51 52 175 177 212 289
10 0 170 171 273
10 1 138
10 2 200 201 257
10 3 87 172 199 200 236 256
10 4 87 122 123 124 199 217 237 255
10 5 86 120 121 122 125 174 238 254 290
10 6 52 53 54 55 56 57 174 290
11 0
11 1 137 189 218 240
11 2 135 136 200 218 242 257
11 3 89 134 135 200 256
11 4 131 132 173 217 222 255
11 5 86 127 254
11 6 57 58 59 60 61 62 127
12 0
12 1 216 240 285
12 2 90 182 183 184 185 202 242
12 3 88 89 179 202 243 268
12 4 88 130 131 133 203 243 244
12 5 128 129 130 178 213 214 215 288
12 6 62 63 64 65 66 67 178 213 215
13 0
13 1
13 2 242
13 3 88 180 181 243 268
13 4 88 203 243 244
13 5 215
13 6 67 68 69 215
