12 48
16 16
8
0 0 0 1 0 1 0 1 0 1 0 1 0 0 0 0 0 0 0 1 0 1 0 1 0 1 0 1 0 0 0 0 0 0 0 0 0 0 0 0 0 2 3 4 3 4 5 6 
7 8 9 10 9 10 9 10 9 10 9 10 0 0 0 0 7 8 9 10 9 10 9 10 9 10 9 10 0 0 0 0 0 0 0 0 0 0 0 0 11 12 13 14 13 14 15 6 
16 17 16 17 16 17 16 17 16 17 16 17 0 1 0 1 16 17 16 17 16 17 16 17 16 17 16 17 0 1 0 1 0 1 0 1 0 1 0 1 6 6 18 19 18 19 20 6 
21 22 23 22 21 22 21 22 21 22 21 22 9 10 9 10 21 22 23 22 21 22 21 22 21 22 21 22 9 10 9 10 9 10 9 10 24 10 24 10 6 25 26 27 28 19 29 6 
16 17 30 31 16 17 16 17 16 17 16 17 16 17 16 17 16 17 30 31 16 17 16 17 16 17 16 17 16 17 16 17 16 17 16 17 30 31 30 31 6 32 33 34 18 19 5 6 
23 22 35 36 23 22 23 22 23 22 23 22 23 22 23 22 23 22 35 36 23 22 23 22 23 22 23 22 23 22 23 22 23 22 23 22 35 36 35 36 6 2 37 6 28 19 15 6 
30 31 6 38 30 31 30 31 30 31 30 31 30 31 30 31 30 31 6 38 30 31 30 31 30 31 30 31 30 31 30 31 30 31 30 31 6 38 6 6 6 32 5 6 18 19 20 6 
35 39 40 41 35 36 35 39 35 39 35 36 35 39 35 36 35 39 40 41 35 36 35 39 35 39 35 36 35 39 35 36 35 36 35 36 40 41 6 6 6 2 42 6 28 43 44 6 
45 46 47 48 49 49 45 46 45 46 49 49 45 46 49 49 45 46 47 48 49 49 45 46 45 46 49 49 45 46 49 49 49 49 50 6 47 48 51 6 52 53 54 6 55 56 20 6 
57 58 59 60 61 61 57 58 57 58 61 61 57 58 61 61 57 58 59 60 61 61 57 58 57 58 61 61 57 58 61 61 61 61 62 63 59 60 64 65 66 67 68 69 68 70 71 69 
72 72 72 72 72 72 72 72 72 72 72 72 72 72 72 72 72 72 72 72 72 72 72 72 72 72 72 72 72 72 72 72 72 72 72 72 72 72 72 72 72 72 72 72 72 72 72 72 
6 6 6 6 6 6 6 6 6 6 6 6 6 6 6 6 6 6 6 6 6 6 6 6 6 6 6 6 6 6 6 6 6 6 6 6 6 6 6 6 6 6 6 6 6 6 6 6 
