12 32
16 16
5
0 1 2 3 4 5 6 7 1 1 4 8 2 3 1 1 6 7 1 1 2 3 6 7 1 1 1 1 2 3 0 0 
0 1 9 10 11 12 6 7 1 1 11 13 9 10 1 1 6 7 1 1 9 10 6 7 1 1 1 1 9 10 0 0 
14 15 4 8 1 1 6 7 16 15 2 3 1 1 1 1 6 7 2 3 1 1 6 7 16 15 2 3 1 1 0 0 
14 17 11 13 1 1 6 7 18 19 9 10 1 1 1 1 6 7 9 10 1 1 6 7 18 19 9 10 1 1 0 0 
14 20 1 1 2 3 6 7 18 19 1 1 21 22 21 22 6 7 4 8 1 1 6 7 18 19 21 22 1 1 0 0 
0 0 1 1 9 10 0 0 0 0 1 1 0 0 0 0 0 0 11 13 1 1 0 0 0 0 0 0 1 1 0 0 
0 1 1 1 18 19 6 7 0 0 1 1 1 1 0 0 0 1 21 22 16 15 0 0 4 8 16 15 1 1 0 0 
0 1 1 1 0 0 6 7 0 0 1 1 1 1 0 0 0 1 0 0 18 19 0 0 11 13 18 19 23 0 0 0 
0 1 2 3 4 8 6 7 0 0 1 1 2 3 0 0 0 1 1 1 18 19 0 0 1 1 24 25 6 7 0 0 
0 1 9 10 11 13 6 7 0 0 1 1 9 10 0 0 0 1 1 1 0 0 0 0 1 1 25 1 6 7 0 0 
0 1 16 15 1 1 6 7 0 0 1 1 1 1 0 0 0 1 1 1 1 1 1 1 24 25 1 1 6 7 0 0 
0 1 18 19 1 1 6 7 0 0 1 1 1 1 0 0 26 1 1 1 1 1 1 1 25 1 1 1 6 7 0 0 
