12 48
16 16
6
0 0 1 2 3 3 3 3 1 2 4 4 4 4 4 4 4 4 4 4 4 4 4 4 4 4 4 4 4 4 4 4 4 4 4 4 4 4 4 4 4 4 4 4 4 4 0 0 
0 0 5 1 3 3 3 3 5 1 4 4 4 4 4 4 4 4 4 4 4 4 4 4 4 4 4 4 4 4 4 4 4 4 4 4 4 4 4 4 4 4 4 4 4 4 0 0 
0 0 3 3 3 3 6 7 3 3 4 4 4 4 4 4 3 8 3 8 4 4 4 4 4 4 4 4 9 10 4 4 4 4 4 4 4 4 4 4 4 4 3 8 3 8 0 0 
0 0 3 3 3 3 11 12 3 3 4 4 4 4 4 4 3 3 3 3 4 4 4 4 4 4 4 4 13 14 4 4 4 4 4 4 4 4 4 4 15 16 3 3 3 3 0 0 
0 0 3 3 3 3 1 2 3 3 4 4 4 4 9 10 17 18 19 20 9 10 4 4 4 4 4 4 21 22 3 8 3 8 3 8 3 8 23 16 24 24 6 7 3 3 0 0 
0 0 3 3 3 3 5 1 3 3 4 4 4 4 13 14 25 4 4 26 13 14 4 4 4 4 4 4 27 3 3 3 3 3 3 3 3 3 24 24 24 24 11 12 3 3 24 28 
0 0 3 3 6 7 21 22 0 0 4 4 19 20 0 0 4 4 4 4 3 3 9 10 9 10 3 8 29 30 3 3 3 3 0 0 31 32 1 2 6 7 3 3 3 3 24 33 
0 0 3 3 11 12 27 3 0 0 4 4 4 26 3 3 34 35 4 4 3 3 13 14 13 14 3 3 36 37 0 0 3 3 38 1 39 31 5 1 11 12 3 3 0 0 24 40 
0 0 3 3 21 22 3 3 3 3 23 16 23 16 6 7 1 2 1 2 3 3 3 3 21 22 0 0 1 2 9 10 3 3 17 18 19 20 31 32 3 3 3 3 1 2 0 0 
0 0 3 3 27 3 3 3 3 3 24 24 24 24 11 12 5 1 5 1 3 3 3 3 27 3 38 1 5 1 13 14 3 3 25 4 4 26 39 31 3 3 0 0 5 1 0 0 
0 0 0 0 41 0 6 7 6 7 0 0 0 0 0 0 0 0 0 0 9 10 0 0 3 3 4 4 0 0 3 3 3 3 4 4 9 10 0 0 0 0 3 3 3 3 0 0 
0 0 0 0 1 42 11 12 11 12 3 3 38 1 38 1 38 1 3 3 13 14 38 1 3 3 34 35 38 1 0 0 0 0 34 35 13 14 38 1 38 1 3 3 3 3 0 0 
